NO ./textures/barrel.png
SO ./textures/eagle.png
WE ./textures/mossy.png
EA ./textures/pillar.png

C 100,200,200
F 100,100,100
11111111111111111111111111111111
10000000000000000000000000000001
10000000000000000000000000000001
10001111111111101111111111110001
10001111111111101111111111110001
10001100000000000000000000110001
10001100000000000000000000000001
100011000E0000000000000000000001
10000000000000000000000000110001
10001111011111111111111111110001
10001111011111111111111111110001
10000000000000000000000000000001
10000000000000000000000000000001
11111111111111111111111111111111