F 255,0,0
C 0,255,0

NO textures/bluestone.png
SO textures/bluestone.png
WE textures/bluestone.png
EA textures/bluestone.png

1111111111111111111111111111111111111111111111111111111
1001001001001000000000000000000000000000000000000000001
1011000001000001000000000000000000000000000000000000001
1001001001111101110000000000000000000000000000000000001
1001111000001001000000000000000000000000000000000000001
1000000000000001000000000000000000000000000000000000001
1001111111111001000000000000000000000000000000000000001
1111000000000001010000000000000000000000000000000000001
1000000001000000000000000000000000000000000000000000001
1000000000000000000000000000000000000000000000000000001
1000000000000000000000000000000000000000000000000000001
1000000000000000000000000000000000000000000000000000001
1000000000000000000000000000000000000000000000000000001
1000000000000000000000000000000000000000000000000000001
1000000000000000000000000000000000000000000000000000001
1000000000000000000000000000000000000000000000000000001
1000000000000000000000000000000000000000000000000000001
1000000000000000000000000000000000000000000000000000001
1000000000000000000000000000000000000000000000000000001
1000000000000000000000000000000000000000000000N00000001
1000000000000000000000000000000000000000000000000000001
1111111111111111111111111111111111111111111111111111111