 	F 0,25,0000000011



SO ./tex 	tures/ mossy.png

NO . / textures/ colorstone . p n 	g


WE . /    t extures  / purplestone.png 	  
  	EA ./textures/redbr ick. 		p n g
	C  	0 , 0 , 	 1	 7

 	111111111111111111111
100000 	001100001100011
1110000011100001110011 	 	 
	 1001000000000000000001111	
11	 	 	 	 		  111		 	 
111111111011000011100	 1101
10100000	 00110000011100011111
1111011111111101110000001010000011
   	 1110111111111111101111000000011
110000001	 1010101110000111001111111
	 	 	 	 	  	  100000000001
11100000000000001101	  1E0000000001
11000000000110101011111   100000000111
1110 	000111010101111101111111111111111111 	
		 11110111 111101 1011101000110011
		    
    11111111110111 11110111111111111111111
